MapID : 2
MinimunCount : 13

0	1	0	1	0
1	1	0	1	1
0	1	0	1	0
1	0	1	0	1
1	0	1	0	1