MapID : 9
MinimunCount : 15

1	0	0	0	1
0	1	0	1	0
0	0	1	0	0
0	1	0	1	0
1	0	0	0	1